
      #######
  ### #B #  #              ####
  # ###  #  #              #  #
  #     ## #################  #
  #         #        A      A #
 ##  #####  # #############   #
 #   #   # ## #           #   #
 #   #   #    #           #####
 #####   ######




